1111111111111
1TT100C0000C1
1C00011111001
1P0T11E0000C1
1111111111111
