1111111111111
1SS100C0000C1
1C00011111001
1P0S11E000001
1111111111111
