1111111111111
100100C0000C1
1C00011111I01
1P00110000001
1111111111111
