1111111111111
100100C000PC1
1C00011111001
1P00110000001
1111111101111
