1111111111111
100100C000EC1
1C000111110001
1P00110000001
1111111111111
